5 4 0 0 0 0 0 0 6 6 6 6 0 0 0 0 0 0 4 5
5 4 0 0 3 0 0 7 6 6 6 6 0 0 0 7 0 0 4 5
5 4 0 0 0 1 0 0 6 6 6 6 0 0 0 0 7 0 4 5
5 4 0 0 7 0 0 0 6 6 6 6 0 3 0 0 0 0 4 5
5 4 0 0 0 0 0 0 6 6 6 6 0 3 3 0 0 0 4 5
5 4 1 0 0 0 0 0 6 6 6 6 0 0 0 0 1 0 4 5
5 4 6 6 6 6 6 6 6 6 6 6 6 6 6 6 6 6 4 5
5 4 6 6 6 6 6 6 6 6 6 6 6 6 6 6 6 6 4 5
5 4 6 6 6 6 6 6 6 6 6 6 6 6 6 6 6 6 4 5
5 4 0 0 0 0 0 0 6 6 6 6 0 0 0 0 0 0 4 5
5 4 0 0 0 0 0 0 6 6 6 6 0 0 0 0 0 0 4 5
5 4 0 0 0 0 0 0 6 6 6 6 0 0 0 0 0 0 4 5
5 4 0 0 0 0 0 0 6 6 6 6 0 0 0 0 0 0 4 5
5 4 0 0 0 0 0 0 6 6 6 6 0 0 0 0 0 0 4 5
5 4 0 0 0 0 0 0 6 6 6 6 0 0 0 0 0 0 4 5