7 7 7 7 7 7 7 7 7 7 7 7 7 7 7 7 7 7 7 6 6 6 7 7 7 7 7 7 7 7 7 7 7 7 7 7 7 7 7 7 7 7 7 7 7 7 7 7 7 7 7 7 7 7 7 7 7 7 7 7
7 7 7 7 7 7 7 7 7 7 7 7 7 7 7 7 7 7 7 6 6 6 7 7 7 7 7 7 7 7 7 7 7 7 7 7 7 7 7 7 7 7 7 7 7 7 7 7 7 7 7 7 7 7 7 7 7 7 7 7
7 7 0 3 0 0 0 0 0 1 1 0 3 0 0 3 0 0 3 6 6 6 6 0 0 7 0 0 0 0 0 0 0 0 0 0 0 0 0 0 0 0 0 0 3 0 0 0 0 7 0 3 0 0 0 7 0 0 7 7
7 7 0 0 0 0 0 0 0 0 0 7 0 3 0 3 0 0 6 6 6 6 0 0 0 0 0 0 0 0 0 0 0 0 0 0 0 0 0 0 0 0 0 0 0 7 0 0 0 0 0 0 0 0 0 0 3 0 7 7
7 7 0 0 0 0 0 0 0 7 0 0 0 0 0 0 0 0 0 6 6 6 6 6 0 0 0 0 0 0 0 3 0 7 0 0 0 0 0 3 0 0 0 0 0 0 0 0 0 0 0 0 0 0 0 0 0 0 7 7
7 7 7 0 0 0 0 0 0 0 6 0 7 6 0 6 3 6 6 6 6 6 6 0 0 0 0 0 0 0 0 0 0 0 0 0 0 0 0 0 0 0 0 0 0 0 0 0 0 0 0 0 0 0 0 0 0 0 7 7
7 7 0 0 0 0 0 0 0 0 0 6 6 6 7 6 0 6 0 6 6 6 7 0 0 0 0 0 0 0 0 0 0 0 0 0 0 0 3 0 0 0 0 0 0 0 0 0 0 0 0 0 0 0 0 0 0 0 7 7
7 7 0 0 0 7 0 0 0 0 6 6 6 6 6 6 6 6 6 6 6 6 6 6 0 0 3 3 0 0 0 0 0 0 0 0 0 0 0 0 0 0 0 0 0 0 0 3 0 0 0 0 0 0 0 0 3 0 7 7
7 7 0 0 0 0 3 0 0 0 0 6 6 6 6 6 6 6 6 6 6 6 6 6 3 0 0 0 7 0 0 3 0 1 3 0 0 0 7 0 0 0 0 0 0 0 0 0 0 0 0 0 3 0 0 0 0 0 7 7
7 7 0 0 0 0 0 0 0 0 6 6 6 6 6 6 6 6 6 6 6 6 0 3 0 0 0 0 0 0 0 0 0 1 0 0 0 0 0 0 0 0 7 0 0 0 0 0 0 0 0 0 1 1 0 7 0 0 7 7
7 7 0 0 0 0 0 0 0 0 6 0 6 0 6 6 6 6 6 6 6 6 6 6 3 0 0 0 0 0 0 3 0 0 0 0 0 0 0 0 0 0 0 0 0 0 0 0 0 0 0 0 3 1 0 0 0 0 7 7
7 7 3 0 0 0 0 0 3 0 0 0 0 6 6 0 6 0 6 6 6 6 0 6 0 0 3 0 0 0 0 0 0 0 0 0 0 0 0 0 0 0 0 0 0 0 0 0 0 0 0 0 0 1 1 0 0 0 7 7
7 7 0 0 0 0 0 3 0 0 0 0 0 7 0 0 0 6 0 6 6 6 0 0 0 1 0 0 0 0 0 0 0 0 0 0 0 0 3 0 0 0 0 0 0 0 0 0 0 0 0 0 0 0 3 0 0 0 7 7
7 7 0 0 0 0 0 0 0 0 0 0 0 0 0 0 0 0 6 6 6 6 6 0 1 1 0 0 0 0 0 0 7 0 0 0 0 0 7 0 0 0 0 0 0 0 0 0 0 0 0 0 0 0 0 0 0 0 7 7
7 7 0 0 7 0 3 0 7 0 0 0 0 0 0 0 0 6 0 6 6 6 6 3 0 7 0 0 0 0 0 0 0 0 0 0 3 0 0 0 0 0 0 0 0 0 0 0 0 0 0 0 0 0 0 0 0 0 7 7
7 7 0 0 0 0 0 0 0 0 0 0 1 0 0 0 0 3 0 6 6 6 3 7 0 0 0 0 0 0 3 0 0 0 0 0 0 0 0 0 0 0 0 0 0 0 3 0 0 0 1 3 0 0 0 3 0 0 7 7
7 7 0 0 0 0 0 0 0 0 0 1 3 0 0 0 0 6 0 6 6 6 6 0 0 0 7 0 0 0 0 3 0 0 0 0 0 3 0 0 0 0 0 0 3 0 0 0 0 0 1 1 0 0 0 0 0 0 7 7
7 7 0 0 7 0 0 0 0 0 0 0 0 0 0 0 0 3 6 6 6 6 6 6 7 6 0 0 6 0 0 0 0 0 0 0 0 6 0 0 0 0 0 0 0 0 0 0 0 0 0 0 0 0 0 0 0 0 7 7
7 7 0 0 0 0 0 0 0 0 0 0 0 0 3 0 0 6 6 6 6 6 6 6 0 0 0 6 3 0 6 0 0 6 6 6 6 0 0 0 0 0 0 0 0 7 0 7 0 0 0 0 0 0 0 0 0 0 7 7
7 7 0 0 0 0 0 0 3 7 0 0 0 0 0 0 3 3 6 6 6 6 6 6 6 6 6 6 6 6 6 6 6 6 6 6 6 6 6 0 0 0 0 0 0 0 0 0 0 0 0 0 7 0 0 0 0 0 7 7
7 7 0 0 3 0 0 0 0 0 0 0 0 0 0 0 0 6 6 6 6 6 6 6 6 6 6 6 6 6 6 6 6 6 6 6 6 6 0 0 0 0 0 0 0 0 0 0 0 0 3 0 0 0 3 0 0 0 7 7
7 7 0 0 0 0 0 0 0 0 0 0 0 0 0 0 0 0 6 6 6 6 6 6 6 6 6 6 6 6 6 6 6 6 6 6 6 6 6 0 0 0 0 0 0 0 0 0 0 0 0 0 0 0 0 0 0 0 7 7
7 7 0 0 7 0 0 0 0 0 0 0 0 0 3 3 0 6 6 6 6 6 6 6 6 6 0 6 6 6 6 6 7 6 0 6 6 6 0 0 0 0 0 0 0 0 0 0 0 0 0 3 0 0 0 0 3 0 7 7
7 7 0 0 0 0 0 0 3 0 0 0 0 0 0 0 6 6 0 6 6 6 6 0 6 6 0 3 6 0 6 0 0 7 6 6 0 0 0 0 0 0 0 0 0 0 0 0 0 0 0 0 0 0 7 0 0 0 7 7
7 7 0 0 0 0 0 0 0 0 7 0 3 0 0 0 6 6 0 6 6 6 6 6 0 7 0 0 0 6 0 3 0 0 3 0 0 0 0 0 0 0 0 3 0 0 0 0 0 0 0 0 0 0 0 0 0 0 7 7
7 7 0 0 0 0 0 0 0 0 0 0 0 0 7 0 0 6 6 6 6 6 6 3 6 0 0 0 0 0 0 0 0 3 0 0 0 7 0 0 0 0 0 0 0 0 0 0 0 0 1 0 0 0 0 0 0 0 7 7
7 7 0 0 0 0 0 0 0 0 0 0 0 0 0 0 0 0 6 6 6 6 0 0 3 0 3 0 0 3 0 0 0 0 0 0 0 0 0 0 0 0 0 0 0 0 0 0 0 0 1 1 0 0 0 0 0 0 7 7
7 7 0 0 0 0 0 0 0 0 0 0 0 0 0 0 3 7 0 6 6 6 0 6 0 0 0 0 0 0 0 7 0 0 0 0 0 0 0 0 0 0 0 0 0 0 0 0 0 0 0 3 0 0 0 0 0 0 7 7
7 7 0 0 0 0 0 0 0 0 0 3 0 0 0 0 0 0 7 6 6 6 6 6 0 0 0 0 0 0 0 0 0 0 0 0 3 0 0 3 0 0 0 0 0 0 0 3 0 0 0 0 0 0 0 0 3 0 7 7
7 7 0 0 0 0 0 0 0 7 1 0 0 1 0 0 0 6 0 6 6 6 6 6 6 0 0 0 0 0 0 0 7 0 0 0 0 0 0 0 0 0 0 0 7 0 0 0 0 0 0 0 0 7 0 0 0 0 7 7
7 7 7 0 0 0 0 0 0 0 0 1 1 0 0 1 0 6 6 6 6 6 6 0 6 0 0 0 0 0 0 0 0 0 0 0 0 0 7 0 0 0 0 0 0 1 3 0 0 0 0 0 0 0 0 0 0 0 7 7
7 7 0 0 0 0 0 0 0 0 0 1 0 0 1 0 1 3 0 6 6 6 0 0 0 0 3 0 0 0 0 0 0 0 3 0 0 0 0 0 0 0 0 0 0 1 1 0 0 0 0 0 0 0 0 0 3 0 7 7
7 7 0 0 0 0 0 0 0 0 0 0 1 0 3 1 0 0 0 6 6 6 6 6 0 0 0 0 0 0 0 3 3 0 0 0 0 0 3 0 0 0 0 3 0 7 0 0 7 0 0 0 3 0 0 0 0 0 7 7
7 7 0 0 7 0 0 0 0 0 1 0 0 0 0 0 0 3 6 6 6 6 6 6 0 6 7 0 0 0 0 3 0 0 0 0 0 0 0 6 0 0 6 0 0 6 7 0 0 0 0 0 0 0 0 7 0 0 7 7
7 7 0 0 0 0 0 0 0 0 0 0 0 0 6 0 6 7 3 6 6 6 0 6 6 0 6 3 6 0 6 0 3 0 3 7 6 6 0 0 3 0 6 0 6 0 6 6 0 0 6 0 0 7 0 0 0 0 0 7
7 7 0 3 0 0 0 3 0 0 0 3 0 0 6 6 6 6 6 6 6 6 6 6 6 6 6 6 6 6 6 6 6 6 6 6 6 6 6 6 6 6 6 6 6 6 6 6 6 6 6 0 0 0 0 0 0 0 0 7
7 7 0 0 0 0 0 0 0 0 0 0 0 0 0 6 6 6 6 6 6 6 6 6 6 6 6 6 6 6 6 6 6 6 6 6 6 6 6 6 6 6 6 6 6 6 6 6 6 6 6 0 0 0 0 0 0 3 0 7
7 7 0 0 0 0 0 0 0 0 0 0 0 0 6 6 6 6 6 6 6 6 6 6 6 6 6 6 6 6 6 6 6 6 6 6 6 6 6 6 6 6 6 6 6 6 6 6 6 6 6 0 0 0 0 3 0 0 0 7
7 7 0 0 0 0 0 7 0 0 0 0 0 0 0 0 6 6 6 6 6 6 6 7 6 0 6 6 0 0 0 0 6 6 6 0 6 0 6 6 0 0 6 0 6 0 6 6 6 0 6 0 3 0 0 0 0 7 0 7
7 7 0 0 0 0 0 0 0 0 0 0 0 0 3 6 6 6 7 6 6 6 7 6 3 6 3 7 0 0 0 0 7 3 0 7 0 0 7 0 0 6 0 6 7 3 0 0 6 6 0 0 0 0 0 0 0 0 0 7
7 7 0 7 0 0 0 0 3 0 0 0 0 0 7 3 0 6 6 6 6 6 0 6 0 7 0 0 3 0 3 0 0 0 3 0 0 0 0 0 0 0 0 0 7 0 0 0 0 0 0 0 0 0 0 7 3 0 0 7
7 7 0 0 0 0 0 0 0 0 0 0 0 0 0 7 0 6 0 6 6 6 6 7 0 0 0 0 0 0 0 0 0 0 0 0 0 0 0 0 0 0 0 0 0 0 0 0 0 0 0 0 0 3 0 0 0 0 0 7
7 7 0 0 0 0 0 0 0 0 0 0 0 0 0 0 0 6 0 6 6 6 6 3 3 0 0 0 0 0 0 0 0 0 0 0 0 0 0 0 0 0 0 0 0 0 0 0 7 0 3 0 0 0 0 0 0 0 0 7
7 7 7 7 7 7 7 7 7 7 7 7 7 7 7 7 7 7 6 6 6 6 7 7 7 7 7 7 7 7 7 7 7 7 7 7 7 7 7 7 7 7 7 7 7 0 7 7 7 7 7 7 7 7 7 7 7 7 7 7
7 7 7 7 7 7 7 7 7 7 7 7 7 7 7 7 7 7 7 6 6 6 7 7 7 7 7 7 7 7 7 7 7 7 7 7 7 7 7 7 7 7 7 7 7 7 7 7 7 7 7 7 7 7 7 7 7 7 7 7